11111111111111111111111
10000000000000000000001
10111001110011100100001
101E0001010010100100001
10111001110011100111001
10000000000000000000001
10110000000000000000001
10110000000001111111111
101100000000001CCC1CCC1
101100000000CCCC1CCC1C1
10000000000011111111111
1000CC00000000000000001
10C01110000000000000001
10C01010000111111111111
10C010100000CCCCCCCCC11
10C010100111C1111110C11
10C010100111C11C0110C11
10C010100111C11C0110C11
10C010000111C11C0110C11
10C011111111C11C0110C11
100000000000CCCC0110P11
11111111111111111111111