11111111111111111111111111
110000111111111111110CCCC1
1011CCC10000000001CCC11111
1E11C1C11111100001C11111P1
1CCCC1CCCCCCC00000CCCCCC01
11111111111111111111111111