11111111
1E000001
10111101
1C0000P1
11111111