11111111
10000001
10000001
10PECCC1
11111111


